1 1 1 1 2 3 46 46 25 26 46 46 49 50 4 5 1 1 1 1 1 1 1 1 1 1 1 1 1 1 1 1 1 1 1 1 1 1 1 1 1 1 1 1 6 7 45 57
1 1 13 14 15 2 46 46 37 38 46 46 49 50 16 17 13 14 13 14 13 14 13 14 46 46 46 46 13 14 46 46 13 14 13 14 46 46 13 14 46 46 13 14 18 20 45 57
1 1 14 27 46 46 2 3 46 46 46 46 49 50 28 29 14 27 6 7 8 9 14 27 25 26 6 7 8 9 4 5 14 27 6 7 8 9 25 26 6 7 8 9 39 51 45 57
1 1 15 14 46 46 15 2 46 46 46 46 49 50 40 41 15 14 18 20 20 21 15 14 37 38 18 20 20 21 16 17 15 14 18 20 20 21 37 38 18 20 20 21 52 53 45 57
1 1 46 46 46 46 46 46 2 3 25 26 49 50 14 27 25 26 20 20 20 20 25 26 14 27 32 20 42 54 28 29 46 46 32 20 20 20 14 27 20 20 20 20 14 27 45 57
1 1 46 46 46 46 46 46 15 2 37 38 49 50 15 14 37 38 19 30 31 54 37 38 15 14 44 20 43 43 40 41 46 46 44 20 33 20 15 14 19 30 31 54 15 14 45 57
1 1 25 26 46 46 1 1 1 1 1 1 49 50 39 51 14 27 39 51 42 54 14 27 25 26 56 20 43 43 14 27 46 46 56 20 56 20 25 26 20 20 43 43 46 46 1 1
1 1 37 38 46 46 13 14 13 14 13 14 49 50 52 53 15 14 52 53 43 43 15 14 37 38 55 20 43 43 15 14 46 46 55 20 55 20 37 38 19 30 43 43 46 46 43 10
1 1 1 1 46 46 25 26 46 46 14 27 49 50 14 27 25 26 1 1 14 27 46 46 46 46 1 1 14 27 25 26 46 46 14 27 14 27 14 27 14 27 46 46 46 46 43 22
1 1 13 14 46 46 37 38 46 46 15 14 49 50 15 14 37 38 13 14 15 14 46 46 46 46 13 14 15 14 37 38 46 46 15 14 15 14 15 14 15 14 46 46 46 46 43 34
1 1 46 46 1 1 1 1 46 46 46 46 49 50 46 46 46 46 46 46 46 46 46 46 46 46 46 46 46 46 46 46 46 46 46 46 46 46 46 46 46 46 1 1 1 1 1 1
1 1 46 46 13 14 13 14 1 1 1 1 1 1 1 1 1 1 1 1 1 1 1 1 1 1 1 1 1 1 1 1 1 1 1 1 1 1 1 1 1 1 1 1 1 1 1 1