1 2 7 21 17 18 3 4 2 2 17 18 7 21 2 2 3 4 2 2 7 21 3 4 2 2 2 2 7 21 1 1
1 2 14 28 24 25 3 4 2 2 24 25 14 28 2 2 3 4 2 2 14 28 3 4 2 2 2 2 14 28 1 1
8 9 17 18 2 2 3 4 12 13 7 21 2 2 2 2 3 4 7 21 2 2 3 4 12 13 7 21 2 2 1 1
15 16 24 25 2 2 3 4 10 11 14 28 2 2 2 2 3 4 14 28 2 2 3 4 10 11 14 28 2 2 1 1
22 21 2 2 7 21 3 4 17 18 2 2 19 20 19 20 3 4 17 18 2 2 3 4 17 18 19 20 2 2 1 1
1 1 2 2 14 28 1 1 1 1 2 2 1 1 1 1 1 1 24 25 2 2 27 1 1 1 1 1 2 2 1 1
1 2 2 2 10 11 3 4 1 1 2 2 2 2 1 1 1 2 19 20 12 13 1 1 17 18 12 13 2 2 1 1
1 2 2 2 1 1 3 4 1 1 2 2 2 2 1 1 1 2 1 1 10 11 1 1 24 25 10 11 26 1 1 1
1 2 7 21 17 18 3 4 1 1 2 2 7 21 1 1 1 2 2 2 17 18 1 1 2 2 5 6 3 4 1 1
1 2 14 28 24 25 3 4 1 1 2 2 14 28 1 1 1 2 2 2 1 1 1 1 2 2 6 2 3 4 1 1
1 2 12 13 2 2 3 4 1 1 2 2 2 2 1 1 1 2 2 2 2 2 2 2 5 6 2 2 3 4 1 1
1 2 10 11 2 2 3 4 1 1 2 2 2 2 1 1 1 2 2 2 2 2 2 2 6 2 2 2 3 4 1 1